aho	aho 	1
ala	ala 	1
apu	apu 	1
aasi	aasi 	1
akku	akku 	1
armo	armo 	1
arpa	arpa 	1
demo	demo 	1
ehto	ehto 	1
keppi	keppi 	1
kirja	kirja 	1
kirjain	kirjain 	1
kilo	kilo 	1
kikka	kikka 	1
kiekko	kiekko 	1
kierto	kierto 	1
leppä	leppä 	1
laguuni	laguuni 	1
laakeri	laakeri 	1
hyponyymi	hyponyymi 	1
humu	humu 	1
hymy	hymy 	1
ihme	ihme 	1
hirmu	hirmu 	1
elämä	elämä 	1
eksistentiaali	eksistentiaali 	1
arrogantti	arrogantti 	1
aito	aito 	1
affiini	affiini 	1
heikohko	heikohko 	1
delikaatti	delikaatti 	1
hervoton	hervoton 	1
häkäinen	häkäinen 	1
halpa	halpa 	1
fiksu	fiksu 	1
haalea	haalea 	1
iloinen	iloinen 	1
vihainen	vihainen 	1
surullinen	surullinen 	1
pelottava	pelottava 	1
rohkea	rohkea 	1
hauska	hauska 	1
laiha	laiha 	1
roteva	roteva 	1
robusti	robusti 	1
hoikka	hoikka 	1
pehmeä	pehmeä 	1
kova	kova 	1
karhea	karhea 	1
sileä	sileä 	1
