500:lla	500:-lla 	2
aamulla	aamu-lla 	2
äänellä	ääne-llä 	2
äänen	ääne-n 	2
äänestäjäkunnan	äänestäjäkunna-n 	2
äänestäjät	äänestäjä-t 	2
äänesti	äänest-i 	2
äänestyksessä	äänestykse-ssä 	2
äänestyspäätökseen	äänestyspäätökse-en 	2
äänestyspäätökselle	äänestyspäätökse-lle 	2
äänestysprosentti	äänestys-prosentti 	2
äänet	ääne-t 	2
ääniharava	ääni-harava 	2
äänikuninkaaksi	äänikuninkaa-ksi 	2
äänimäärä	ääni-määrä 	2
äänisaaliin	äänisaalii-n 	2
ääntä	ään-tä 	2
aiemman	aiemma-n 	2
aiemmasta	aiemma-sta 	2
aihetta	aihet-ta 	2
aiheuttaa	aiheutta-a 	2
aikaa	aika-a 	2
aikaiset	aikaise-t 	2
aikoja	aiko-ja 	2
aikoo	aiko-o 	2
aineiston	aineisto-n 	2
ainoaa	ainoa-a 	2
ajalla	aja-lla 	2
ajanut	aja-nut 	2
ajatella	ajatell-a 	2
ajatellut	ajatel-lut 	2
akateemisen	akateemise-n 	2
aktiivisuuden	aktiivisuude-n 	2
alalla	ala-lla 	2
aletaan	ale-taan 	2
alkaa	alka-a 	2
alkanut	alka-nut 	2
alkoholia	alkoholi-a 	2
alkoholilain	alkoholilai-n 	2
alkoi	alko-i 	2
alkuvuonna	alku-vuonna 	2
aloitettiin	aloitet-tiin 	2
alussa	alus-sa 	2
Andersson-ilmiöstä	Andersson-ilmiöstä 	2
Anna-Maja	Anna-Maja 	2
antaa	anta-a 	2
arkkunsa	arkku-nsa 	2
arvelee	arvele-e 	2
arvioitu	arvioi-tu 	2
arvion	arvio-n 	2
arvoiseksi	arvoise-ksi 	2
arvokartalla	arvokarta-lla 	2
arvoon	arvo-on 	2
arvostetaan	arvoste-taan 	2
asemaa	asema-a 	2
asettanut	asetta-nut 	2
asiaan	asia-an 	2
asiakasviestillä	asiakasviesti-llä 	2
asian	asia-n 	2
asiaosaamista	asiaosaamis-ta 	2
asiapoliitikon	asiapoliitiko-n 	2
asiasta	asia-sta 	2
asiat	asia-t 	2
Asti-kuohuviinit	Asti-kuohuviinit 	2
A-Studio	A-Studio 	2
asuntovelallisten	asuntovelallis-ten 	2
ATK-erikoistutkija	ATK-erikoistutkija 	2
aurinkoisessa	aurinkoise-ssa 	2
avasi	avas-i 	2
avoimen	avoime-n 	2
avoimin	avoim-in 	2
avointa	avoin-ta 	2
avustajana	avustaja-na 	2
biljoonan	biljoona-n 	2
blokin	bloki-n 	2
blokkiin	blokki-in 	2
buukattu	buukat-tu 	2
datanomi	data-nomi 	2
dollarin	dollari-n 	2
edellisessä	edellise-ssä 	2
edellyttämä	edellyttä-mä 	2
ehditty	ehdit-ty 	2
ehdokaslista	ehdokas-lista 	2
ehdokasta	ehdokas-ta 	2
ehdokkaana	ehdokkaa-na 	2
ehdokkaan	ehdokkaa-n 	2
ehdokkaansa	ehdokkaa-nsa 	2
ehdokkaat	ehdokkaa-t 	2
ehdolla	ehdo-lla 	2
ehdottaa	ehdotta-a 	2
ehdotuksen	ehdotukse-n 	2
ehti	eht-i 	2
eli	el-i 	2
EM-hopeaa	EM-hopeaa 	2
EM-kisat|Ruotsalaisten	EM-kisat|Ruotsalaisten 	2
EM-kisoissa	EM-kisoissa 	2
englantiin	englanti-in 	2
ennakoitu	ennakoi-tu 	2
ennätyksen	ennätykse-n 	2
ennestään	ennestä-än 	2
ensimmäiseen	ensimmäise-en 	2
ensimmäisellä	ensimmäise-llä 	2
ensimmäiselle	ensimmäise-lle 	2
ensimmäisen	ensimmäise-n 	2
ensimmäisestä	ensimmäise-stä 	2
ensimmäistä	ensimmäis-tä 	2
epäillä	epäill-ä 	2
epäilty	epäil-ty 	2
epäonnistui	epäonnistu-i 	2
erilaisen	erilaise-n 	2
erillisen	erillise-n 	2
erityisen	erityise-n 	2
erityisrahoituksella	erityisrahoitukse-lla 	2
eronnut	eron-nut 	2
erosi	eros-i 	2
erot	ero-t 	2
erottua	erottu-a 	2
esiintyi	esiinty-i 	2
esiintyy	esiinty-y 	2
esitutkinta	esi-tutkinta 	2
esitystapa	esitys-tapa 	2
etsivät	etsivä-t 	2
etua	etu-a 	2
etukäteen	etu-käteen 	2
EU:n	EU:-n 	2
euroa	euro-a 	2
euroalueen	euroaluee-n 	2
eurolla	euro-lla 	2
euron	euro-n 	2
Euroopan	Euroopa-n 	2
eurooppalaisen	eurooppalaise-n 	2
eurovaalikoneen	eurovaalikonee-n 	2
eurovaalitulos	eurovaali-tulos 	2
eurovaaliyllätykselle	eurovaaliyllätykse-lle 	2
faktaan	fakta-an 	2
faktan	fakta-n 	2
finaaliin	finaali-in 	2
finaalipaikan	finaalipaika-n 	2
FIN-CLARIN	FIN-CLARIN 	2
firman	firma-n 	2
Flow-festivaaleille	Flow-festivaaleille 	2
fysiikasta	fysiika-sta 	2
gallupit	gallupi-t 	2
gallup-kannatuksen	gallupkannatukse-n 	2
gradun	gradu-n 	2
haastattelussa	haastattelu-ssa 	2
haaveiltiin	haaveil-tiin 	2
haihtuminen	haihtu-minen 	2
haki	hak-i 	2
hakoteillä	hako-teillä 	2
hallintoministerinä	hallintoministeri-nä 	2
hallitukseen	hallitukse-en 	2
hallituksen	hallitukse-n 	2
hallituksessa	hallitukse-ssa 	2
hallituksesta	hallitukse-sta 	2
hallitusratkaisut	hallitusratkaisu-t 	2
hallitusta	hallitus-ta 	2
halusi	halus-i 	2
hänellä	häne-llä 	2
hänelle	häne-lle 	2
hänen	häne-n 	2
hankkeeseen	hankkee-seen 	2
harrastanut	harrasta-nut 	2
havainnot	havainno-t 	2
hävitä	hävit-ä 	2
helppoa	helppo-a 	2
Helsingin	Helsingi-n 	2
henkilöä	henkilö-ä 	2
henkilöiden	henkilöid-en 	2
henkilöityy	henkilöity-y 	2
henkilökohtainen	henkilö-kohtainen 	2
henkilönä	henkilö-nä 	2
henkilövaalit	henkilövaali-t 	2
heränneensä	herännee-nsä 	2
herkässä	herkä-ssä 	2
hetkeen	hetke-en 	2
hetkellä	hetke-llä 	2
HFST-nimisellä	HFST-nimisellä 	2
hieraista	hieraist-a 	2
hinnalla	hinna-lla 	2
hinnasta	hinna-sta 	2
hinnoitellaan	hinnoitel-laan 	2
hipsuttelusta	hipsuttelu-sta 	2
historialliseen	historiallise-en 	2
historian	historia-n 	2
hoitaa	hoita-a 	2
hopealla	hopea-lla 	2
humanistina	humanisti-na 	2
humanistiopiskelijat	humanistiopiskelija-t 	2
humanististen	humanistis-ten 	2
huolehtii	huolehti-i 	2
huomauttaa	huomautta-a 	2
huoneeseen	huonee-seen 	2
hurmoksellinen	hurmokse-llinen 	2
hylätä	hylät-ä 	2
hyötyä	hyöty-ä 	2
hyväksyi	hyväksy-i 	2
hyväksyttävää	hyväksyttävä-ä 	2
hyvän	hyvä-n 	2
hyvässä	hyvä-ssä 	2
hyvinkin	hyvin-kin 	2
ihmiselle	ihmise-lle 	2
ihmisen	ihmise-n 	2
ihmiset	ihmise-t 	2
ihmisten	ihmis-ten 	2
ilmentää	ilmentä-ä 	2
ilmiön	ilmiö-n 	2
ilmoitti	ilmoitt-i 	2
iloisena	iloise-na 	2
iloitsee	iloitse-e 	2
iltakin	ilta-kin 	2
inflaatiokehityksellä	inflaatiokehitykse-llä 	2
inhimillisen	inhimillise-n 	2
Instagram-vaalit	Instagram-vaalit 	2
instituutin	instituuti-n 	2
irronnut	irron-nut 	2
isäntämaa	isäntä-maa 	2
isoon	iso-on 	2
isot	iso-t 	2
istunut	istu-nut 	2
istuu	istu-u 	2
itselle	itse-lle 	2
itsenäisenä	itsenäise-nä 	2
itsensä	itse-nsä 	2
itsessään	itsessä-än 	2
jäädä	jääd-ä 	2
jäämässä	jäämä-ssä 	2
jäi	jä-i 	2
jakaminen	jaka-minen 	2
jälkeen	jälke-en 	2
jälkipyykin	jälkipyyki-n 	2
Jan-Erik	Jan-Erik 	2
jaostopäällikkö	jaosto-päällikkö 	2
järjestellä	järjestell-ä 	2
järjestettävään	järjestettävä-än 	2
järjestöuran	järjestöura-n 	2
järjestyy	järjesty-y 	2
jäseneksi	jäsene-ksi 	2
jäsenenä	jäsene-nä 	2
jäsenyydet	jäsenyyde-t 	2
jatkaa	jatka-a 	2
jatkuu	jatku-u 	2
jatkuvat	jatkuva-t 	2
jatkuvuuden	jatkuvuude-n 	2
jättää	jättä-ä 	2
johdon	johdo-n 	2
johon	jo-hon 	2
johtajan	johtaja-n 	2
johtajuutta	johtajuut-ta 	2
johtanut	johta-nut 	2
johti	joht-i 	2
jossa	jo-ssa 	2
josta	jo-sta 	2
joukkoon	joukko-on 	2
joukossa	jouko-ssa 	2
joutui	joutu-i 	2
juhannuksen	juhannukse-n 	2
juhlaa	juhla-a 	2
juhlat	juhla-t 	2
juhlii	juhli-i 	2
julkisuuteen	julkisuute-en 	2
juoksen	juokse-n 	2
juossut	juos-sut 	2
juryn	jury-n 	2
juttua	juttu-a 	2
jutun	jutu-n 	2
jutussa	jutu-ssa 	2
jyväskyläläinen	jyvä-skyläläinen 	2
käännytään	käänny-tään 	2
käännytyslaissa	käännytyslai-ssa 	2
kääntöpuoli	kääntö-puoli 	2
kabinetissa	kabineti-ssa 	2
kahdeksanneksi	kahdeksanne-ksi 	2
kahdella	kahde-lla 	2
kahteen	kahte-en 	2
kahvikeskustelut	kahvikeskustelu-t 	2
kaikkea	kaikke-a 	2
kaksitasomalli	kaksi-tasomalli 	2
kaltaiseksi	kaltaise-ksi 	2
kampanjoinut	kampanjoi-nut 	2
kannattaa	kannatta-a 	2
kannattajat	kannattaja-t 	2
kannattavuutta	kannattavuut-ta 	2
kansanedustaja	kansan-edustaja 	2
kansan	kansa-n 	2
kappaletta	kappalet-ta 	2
karsintaan	karsinta-an 	2
käsittävä	käsittä-vä 	2
kasvua	kasvu-a 	2
katetta	katet-ta 	2
katsoa	katso-a 	2
kaudella	kaude-lla 	2
kauden	kaude-n 	2
kaupalliset	kaupallise-t 	2
kaupallisten	kaupallis-ten 	2
kaupankäynti	kaupan-käynti 	2
kauppaan	kauppaa-n 	2
käydä	käyd-ä 	2
käynnistyi	käynnisty-i 	2
käyntiin	käynti-in 	2
käynyt	käy-nyt 	2
käytännössä	käytännö-ssä 	2
käytetään	käyte-tään 	2
käytetyn	käytety-n 	2
käytöksestä	käytökse-stä 	2
käyttää	käyttä-ä 	2
kehittyminen	kehitty-minen 	2
kehuu	kehu-u 	2
keksinnön	keksinnö-n 	2
kelvollisten	kelvollis-ten 	2
kenraalimajuri	kenraali-majuri 	2
keräsi	keräs-i 	2
kertoo	kerto-o 	2
kertynyt	kerty-nyt 	2
kesällä	kesä-llä 	2
kesänä	kesä-nä 	2
kesästä	kesä-stä 	2
keskenään	keskenä-än 	2
keskilinjan	keskilinja-n 	2
keskiössä	keskiö-ssä 	2
keskittynyt	keskitty-nyt 	2
keskuspankki	keskus-pankki 	2
keskustan	keskusta-n 	2
keskustassa	keskusta-ssa 	2
keväällä	kevää-llä 	2
kevään	kevää-n 	2
kielellä	kiele-llä 	2
kielelle	kiele-lle 	2
kielen	kiele-n 	2
kielestä	kiele-stä 	2
kieliteknologian	kieliteknologia-n 	2
kieliteknologisesta	kieliteknologise-sta 	2
kielitiede	kieli-tiede 	2
kieltä	kiel-tä 	2
kielten	kiel-ten 	2
kierrokselle	kierrokse-lle 	2
kihinävaiheen	kihinävaihee-n 	2
kiinnostavuudesta	kiinnostavuude-sta 	2
kirittänyt	kirittä-nyt 	2
kirjaan	kirjaa-n 	2
kirjattiin	kirjat-tiin 	2
kirjoittajat	kirjoittaja-t 	2
kirjoittanut	kirjoitta-nut 	2
kirjoitti	kirjoitt-i 	2
kirjoja	kirjo-ja 	2
kisapäivän	kisapäivä-n 	2
KIT-tutkijakoulu	KIT-tutkijakoulu 	2
KIT-tutkijakoulun	KIT-tutkijakoulun 	2
KIT-verkosto	KIT-verkosto 	2
koettiin	koet-tiin 	2
koettu	koet-tu 	2
koetusta	koetus-ta 	2
kohdistuu	kohdistu-u 	2
kohteeksi	kohtee-ksi 	2
kohut	kohu-t 	2
kokemukseni	kokemukse-ni 	2
kokeneen	kokenee-n 	2
koki	kok-i 	2
kokonaisarvo	kokonais-arvo 	2
kokoomuksen	kokoomukse-n 	2
kokoomusehdokkuuden	kokoomusehdokkuude-n 	2
kokoomusta	kokoomus-ta 	2
kokoukselle	kokoukse-lle 	2
kokousten	kokous-ten 	2
kolmanneksi	kolmanne-ksi 	2
kolmeen	kolme-en 	2
kolmella	kolme-lla 	2
kolmen	kolme-n 	2
kolmessa	kolme-ssa 	2
kolmesta	kolme-sta 	2
kolmiloikkavalmentaja	kolmi-loikkavalmentaja 	2
komissaariehdokkaaksi	komissaariehdokkaa-ksi 	2
komissaarikaudella	komissaarikaude-lla 	2
komissaariksi	komissaari-ksi 	2
kommentoinut	kommentoi-nut 	2
koneet	konee-t 	2
korjaantui	korjaantu-i 	2
korkeampi	korkea-mpi 	2
korkoa	korko-a 	2
korkojohdannaiset	korkojohdannaise-t 	2
koron	koro-n 	2
korostaa	korosta-a 	2
korruptoitunut	korruptoitu-nut 	2
korvata	korvat-a 	2
koskee	koske-e 	2
koulutuksen	koulutukse-n 	2
koulutusta	koulutus-ta 	2
K-Supermarketissa	K-Supermarketissa 	2
K-Supermarketista	K-Supermarketista 	2
kuitata	kuitat-a 	2
kullalla	kulla-lla 	2
kulttuurišokkia	kulttuurišokki-a 	2
kuluva	kulu-va 	2
kumosi	kumos-i 	2
kunnian	kunnia-n 	2
kuntaministerinä	kuntaministeri-nä 	2
kuplaksi	kupla-ksi 	2
kutistui	kutistu-i 	2
kutsuttiin	kutsut-tiin 	2
kuuli	kuul-i 	2
kuullut	kuul-lut 	2
kuuluvat	kuuluva-t 	2
kuvaavat	kuvaava-t 	2
kuvailee	kuvaile-e 	2
kuvan	kuva-n 	2
kuvassa	kuva-ssa 	2
kuvata	kuvat-a 	2
kuvitellaan	kuvitel-laan 	2
kuvitteli	kuvittel-i 	2
kv-toimintaa	kv-toimintaa 	2
kymmeneksi	kymmene-ksi 	2
kymmenkertaistui	kymmenkertaistu-i 	2
kyseessä	kysee-ssä 	2
kyseisen	kyseise-n 	2
kysyy	kysy-y 	2
laadulle	laadu-lle 	2
laadun	laadu-n 	2
laajaan	laaja-an 	2
laajentaminen	laajenta-minen 	2
laatiminen	laati-minen 	2
lager-oluen	lager-oluen 	2
lähdekoodin	lähdekoodi-n 	2
lähdössä	lähdö-ssä 	2
läheiset	läheise-t 	2
lähettää	lähettä-ä 	2
lähtee	lähte-e 	2
laihan	laiha-n 	2
lainmuutos	lain-muutos 	2
Langnet-tutkijakoulun	Langnet-tutkijakoulun 	2
lannistuu	lannistu-u 	2
laskentakeskuksen	laskentakeskukse-n 	2
laskentakeskuksessa	laskentakeskukse-ssa 	2
laskentakeskuksesta	laskentakeskukse-sta 	2
laskettiin	lasket-tiin 	2
laskettu	lasket-tu 	2
laski	lask-i 	2
laskuodotusten	laskuodotus-ten 	2
laudatur-tason	laudaturtaso-n 	2
lauotaan	lauo-taan 	2
leikkaukset	leikkaukse-t 	2
levätä	levät-ä 	2
liikenteen	liikentee-n 	2
liikkeet	liikkee-t 	2
liittyi	liitty-i 	2
liittyy	liitty-y 	2
Lingsoft-nimisen	Lingsoft-nimisen 	2
lingvistisesti	lingvistise-sti 	2
lingvistit	lingvisti-t 	2
linjan	linja-n 	2
linjassa	linja-ssa 	2
linjasta	linja-sta 	2
lisäpaikalla	lisäpaika-lla 	2
lisäpaikan	lisäpaika-n 	2
lisärahoitusta	lisärahoitus-ta 	2
lisätä	lisät-ä 	2
listalle	lista-lle 	2
listan	lista-n 	2
litrahinta	litra-hinta 	2
litran	litra-n 	2
lohdun	lohdu-n 	2
loikki	loikk-i 	2
loikkiminen	loikki-minen 	2
loitontaa	loitonta-a 	2
lomaa	loma-a 	2
lopun	lopu-n 	2
löytää	löytä-ä 	2
löytyi	löyty-i 	2
löytynyt	löyty-nyt 	2
lukea	luke-a 	2
lukemaan	lukema-an 	2
lukumäärä	luku-määrä 	2
luonnonsuojelu-	luonnon-suojelu- 	2
luontevaa	luonteva-a 	2
luopua	luopu-a 	2
luopui	luopu-i 	2
luottaa	luotta-a 	2
luulla	luull-a 	2
luullut	luul-lut 	2
maahan	maa-han 	2
maailman	maailma-n 	2
maanantaiaamuna	maanantaiaamu-na 	2
maanantaihin	maanantai-hin 	2
maanantailta	maanantai-lta 	2
maanantaina	maanantai-na 	2
maan	maa-n 	2
määrässä	määrä-ssä 	2
mahdollisena	mahdollise-na 	2
mahdollisuutta	mahdollisuut-ta 	2
mahtaa	mahta-a 	2
mallin	malli-n 	2
maratonin	maratoni-n 	2
Marin-ilmiö	Marin-ilmiö 	2
Marin-ilmiöstä	Marin-ilmiöstä 	2
markkina-arvo	markkina-arvo 	2
markkinapsykologisesta	markkinapsykologise-sta 	2
matalan	matala-n 	2
matemaatikkona	matemaatikko-na 	2
matematiikasta	matematiika-sta 	2
matkaan	matkaa-n 	2
matkalla	matka-lla 	2
median	media-n 	2
mediassa	media-ssa 	2
menestyksen	menestykse-n 	2
menestyksensä	menestykse-nsä 	2
menetelmällä	menetelmä-llä 	2
menetelmän	menetelmä-n 	2
menettää	menettä-ä 	2
menetti	menett-i 	2
merkitystä	merkitys-tä 	2
metrillä	metri-llä 	2
mielekkyyttä	mielekkyyt-tä 	2
mielestään	mielestä-än 	2
mielestäni	mielestä-ni 	2
mielin	mieli-n 	2
mieluisaa	mieluisa-a 	2
mieluisana	mieluisa-na 	2
miesten	mies-ten 	2
millaista	millais-ta 	2
minkäs	minkä-s 	2
mitalia	mitali-a 	2
mitalitaulukkoa	mitalitaulukko-a 	2
mitalit	mitali-t 	2
mökillä	möki-llä 	2
monella	mone-lla 	2
monen	mone-n 	2
muistion	muistio-n 	2
muistona	muisto-na 	2
muistoni	muisto-ni 	2
mukanaan	mukana-an 	2
muodollista	muodollis-ta 	2
muodon	muodo-n 	2
muotoilla	muotoill-a 	2
muotoisesta	muotoise-sta 	2
muun	muu-n 	2
muutamassa	muutama-ssa 	2
muut	muu-t 	2
muutoksen	muutokse-n 	2
muutosta	muutos-ta 	2
muuttui	muuttu-i 	2
muuttunut	muuttu-nut 	2
myöntäen	myöntä-en 	2
myötäilee	myötäile-e 	2
myötävaikutuksella	myötävaikutukse-lla 	2
myynnin	myynni-n 	2
myyntiä	myynti-ä 	2
myyntiin	myynti-in 	2
myyntijohtaja	myynti-johtaja 	2
naamalla	naama-lla 	2
nähdä	nähd-ä 	2
nähnyt	näh-nyt 	2
naiset	naise-t 	2
naisten	nais-ten 	2
näkee	näke-e 	2
näkyi	näky-i 	2
näkyvyydestä	näkyvyyde-stä 	2
näkyy	näky-y 	2
nauraa	naura-a 	2
naurettiin	nauret-tiin 	2
neljään	neljä-än 	2
neljännestä	neljännes-tä 	2
neuvottelut	neuvottelu-t 	2
niiden	niide-n 	2
Nordnet-palvelun	Nordnet-palvelun 	2
nostaa	nosta-a 	2
nousee	nouse-e 	2
nousi	nous-i 	2
noussut	nous-sut 	2
nousukiitoa	nousukiito-a 	2
nousussa	nousu-ssa 	2
noususta	nousu-sta 	2
nousuvaraa	nousuvara-a 	2
nuorten	nuor-ten 	2
Nvidia-omistuksien	Nvidia-omistuksien 	2
Nvidia-osake	Nvidia-osake 	2
Nvidia-osakkeeksi	Nvidia-osakkeeksi 	2
nykiä	nyki-ä 	2
nykyisen	nykyise-n 	2
nykyistä	nykyis-tä 	2
odotetaan	odote-taan 	2
odoteta	odote-ta 	2
odotettu	odotet-tu 	2
odotukset	odotukse-t 	2
ohittanut	ohitta-nut 	2
ohjelmana	ohjelma-na 	2
ohjelmointikurssille	ohjelmointikurssi-lle 	2
oikaistiin	oikais-tiin 	2
oikein	oike-in 	2
olen	ole-n 	2
olevan	oleva-n 	2
olevansa	oleva-nsa 	2
olevasta	oleva-sta 	2
oli	ol-i 	2
olisi	ol-isi 	2
olla	oll-a 	2
ollutkaan	ollut-kaan 	2
omalta	oma-lta 	2
omasta	oma-sta 	2
omia	omi-a 	2
omistautua	omistautu-a 	2
ongelmaan	ongelma-an 	2
ongelmaa	ongelma-a 	2
onkin	on-kin 	2
onko	on-ko 	2
opettajani	opettaja-ni 	2
opetuksen	opetukse-n 	2
opetusministeri	opetus-ministeri 	2
organisaation	organisaatio-n 	2
organisointia	organisointi-a 	2
osakekurssilla	osakekurssi-lla 	2
osakesalkusta	osakesalku-sta 	2
osaketta	osaket-ta 	2
osakkeeksi	osakkee-ksi 	2
osakkeen	osakkee-n 	2
osalta	osa-lta 	2
ostetaan	oste-taan 	2
osuudella	osuude-lla 	2
osviittaa	osviitta-a 	2
ottaa	otta-a 	2
Oulun	Oulu-n 	2
pääasiallinen	pää-asiallinen 	2
pääministeri	pää-ministeri 	2
pääsee	pääse-e 	2
päästä	pääst-ä 	2
päästi	pääst-i 	2
päästy	pääs-ty 	2
päätöksen	päätökse-n 	2
päättäjänä	päättäjä-nä 	2
päättämä	päättä-mä 	2
päätyä	pääty-ä 	2
pahoittelee	pahoittele-e 	2
paikalleen	paikalle-en 	2
paikan	paika-n 	2
paikasta	paika-sta 	2
paikkaan	paikkaa-n 	2
paikkamääränsä	paikkamäärä-nsä 	2
paikkansa	paikka-nsa 	2
painui	painu-i 	2
painuminen	painu-minen 	2
päivää	päivä-ä 	2
päivänä	päivä-nä 	2
päiväni	päivä-ni 	2
päivät	päivä-t 	2
palaset	palase-t 	2
palasi	palas-i 	2
palauttanut	palautta-nut 	2
palautui	palautu-i 	2
palaverin	palaveri-n 	2
paljastui	paljastu-i 	2
paljastuu	paljastu-u 	2
paljouden	paljoude-n 	2
palkata	palkat-a 	2
palvelun	palvelu-n 	2
paperin	paperi-n 	2
paranee	parane-e 	2
parasta	paras-ta 	2
paremman	paremma-n 	2
parin	pari-n 	2
parlamentaarikon	parlamentaariko-n 	2
parlamentin	parlamenti-n 	2
parlamenttityölle	parlamenttityö-lle 	2
peräkkäisen	peräkkäise-n 	2
perhevapaalla	perhevapaa-lla 	2
perinteistä	perinteis-tä 	2
perjantaina	perjantai-na 	2
perjantaista	perjantais-ta 	2
perusmatematiikan	perusmatematiika-n 	2
peruspalveluministerinä	peruspalveluministeri-nä 	2
perussuomalaisena	perussuomalaise-na 	2
perussuomalaisen	perussuomalaise-n 	2
perussuomalaiset	perussuomalaise-t 	2
perussuomalaisten	perussuomalais-ten 	2
perustaa	perusta-a 	2
perustat	perusta-t 	2
perusteella	perustee-lla 	2
perustettiin	perustet-tiin 	2
pidetään	pide-tään 	2
pidettävää	pidettävä-ä 	2
pieneksi	piene-ksi 	2
pienellä	piene-llä 	2
pienempi	piene-mpi 	2
pienin	pieni-n 	2
piensijoittaja	pien-sijoittaja 	2
piikistä	piiki-stä 	2
pintaan	pinta-an 	2
pitää	pitä-ä 	2
pitäisi	pitä-isi 	2
pitänyt	pitä-nyt 	2
piti	pit-i 	2
pitkään	pitkä-än 	2
pitkän	pitkä-n 	2
plakkariin	plakkari-in 	2
pohdinnan	pohdinna-n 	2
pohjalta	pohja-lta 	2
poikkeukselliseksi	poikkeuksellise-ksi 	2
poikkeuksellista	poikkeuksellis-ta 	2
poikkeukset	poikkeukse-t 	2
pointit	pointi-t 	2
poistettu	poistet-tu 	2
pokkasi	pokkas-i 	2
poliisin	poliisi-n 	2
poliitikon	poliitiko-n 	2
poliitikot	poliitiko-t 	2
poliittisen	poliittise-n 	2
politiikkaa	politiikka-a 	2
polkua	polku-a 	2
pompittiin	pompit-tiin 	2
portugalilaisten	portugalilais-ten 	2
poseeraaminen	poseeraa-minen 	2
poseerausta	poseeraus-ta 	2
pottia	potti-a 	2
pottiin	potti-in 	2
pöydälle	pöydä-lle 	2
presidentiksi	presidenti-ksi 	2
presidentin	presidenti-n 	2
presidenttikampanjassa	presidenttikampanja-ssa 	2
presidenttinä	presidentti-nä 	2
professorina	professori-na 	2
pronssilla	pronssi-lla 	2
prosentilla	prosenti-lla 	2
prosentin	prosenti-n 	2
prosentista	prosenti-sta 	2
prosenttia	prosentti-a 	2
prosenttiin	prosentti-in 	2
prosenttisen	prosenttise-n 	2
protestin	protesti-n 	2
pudonnut	pudon-nut 	2
puheenjohtaja	puheen-johtaja 	2
puheenjohtajuus	puheen-johtajuus 	2
puhemies	puhe-mies 	2
puhisi	puhis-i 	2
puhunut	puhu-nut 	2
puhutaan	puhu-taan 	2
puhuttiin	puhut-tiin 	2
pulssikin	pulssi-kin 	2
punaväriä	punaväri-ä 	2
puntaroida	puntaroid-a 	2
puolelle	puole-lle 	2
puolen	puole-n 	2
puolestaan	puolesta-an 	2
puolet	puole-t 	2
puolimaratonin	puolimaratoni-n 	2
puolitoista	puoli-toista 	2
puolivälissä	puolivälis-sä 	2
puolueen	puoluee-n 	2
puolueensa	puoluee-nsa 	2
puolueeseen	puoluee-seen 	2
puolueesta	puoluee-sta 	2
puoluetta	puoluet-ta 	2
puun	puu-n 	2
pyöritystä	pyöritys-tä 	2
pyrkiä	pyrki-ä 	2
pystyi	pysty-i 	2
pysynyt	pysy-nyt 	2
pyysi	pyys-i 	2
pyytää	pyytä-ä 	2
rahoitettiin	rahoitet-tiin 	2
rahoituksen	rahoitukse-n 	2
rahoitusta	rahoitus-ta 	2
rajalle	raja-lle 	2
rakennettiin	rakennet-tiin 	2
ratkaisua	ratkaisu-a 	2
ratkaisun	ratkaisu-n 	2
rehtorimme	rehtori-mme 	2
riittänyt	riittä-nyt 	2
riskipreemiota	riskipreemio-ta 	2
romahduksesta	romahdukse-sta 	2
roolia	rooli-a 	2
rutiiniksi	rutiini-ksi 	2
ruusuiset	ruusuise-t 	2
ryhmän	ryhmä-n 	2
saada	saad-a 	2
saaliiksi	saalii-ksi 	2
säännöllisestä	säännöllise-stä 	2
sääntelyä	sääntely-ä 	2
saanut	saa-nut 	2
saapui	saapu-i 	2
säässä	sää-ssä 	2
saatiin	saa-tiin 	2
säätöä	säätö-ä 	2
saattaa	saatta-a 	2
saattoi	saatto-i 	2
sadalla	sada-lla 	2
sadan	sada-n 	2
sai	sa-i 	2
saisi	sa-isi 	2
säkenöinyt	säkenöi-nyt 	2
salata	salat-a 	2
salaukset	salaukse-t 	2
saliin	sali-in 	2
sanaa	sana-a 	2
sanaisen	sanaise-n 	2
sanoo	sano-o 	2
sanottuun	sanottu-un 	2
saralla	sara-lla 	2
sarjan	sarja-n 	2
S&D-ryhmän	S&D-ryhmän 	2
seisoo	seiso-o 	2
seitsemällä	seitsemä-llä 	2
seitsemältä	seitsemä-ltä 	2
sekään	se-kään 	2
sekoilun	sekoilu-n 	2
selittää	selittä-ä 	2
selitti	selitt-i 	2
selittyy	selitty-y 	2
sellaisen	sellaise-n 	2
selvää	selvä-ä 	2
selvinnyt	selvin-nyt 	2
selvisi	selvis-i 	2
seminaariin	seminaari-in 	2
senttiosakkeeksi	senttiosakkee-ksi 	2
seuraajaa	seuraaja-a 	2
seuraavana	seuraava-na 	2
seuraavan	seuraava-n 	2
seuraavat	seuraava-t 	2
siemenrahaa	siemenraha-a 	2
siirtyy	siirty-y 	2
siitä	siit-ä 	2
sijaan	sijaa-n 	2
sijassa	sija-ssa 	2
sijasta	sija-sta 	2
sijoittajat	sijoittaja-t 	2
sijoittuu	sijoittu-u 	2
silloisesta	silloise-sta 	2
silmänsä	silmä-nsä 	2
siltä	si-ltä 	2
siruyhtiön	siruyhtiö-n 	2
sisäisellä	sisäise-llä 	2
sisältää	sisältä-ä 	2
sitoutumattomana	sitoutumattoma-na 	2
sitoutunut	sitoutu-nut 	2
S-marketin	S-marketin 	2
S-marketissa	S-marketissa 	2
S-marketista	S-marketista 	2
some-keskustelusta	some-keskustelusta 	2
some-tutkijalle	some-tutkijalle 	2
sopi	sop-i 	2
sosiaalisen	sosiaalise-n 	2
sosiaalisessa	sosiaalise-ssa 	2
sotaan	sota-an 	2
soveltaminen	sovelta-minen 	2
splittauksella	splittaukse-lla 	2
splittaushetkellä	splittaushetke-llä 	2
splittausta	splittaus-ta 	2
S-ryhmän	S-ryhmän 	2
S-ryhmässäkin	S-ryhmässäkin 	2
S-ryhmässä	S-ryhmässä 	2
S-ryhmien	S-ryhmien 	2
suhtautui	suhtautu-i 	2
suhteessa	suhtee-ssa 	2
sujunut	suju-nut 	2
sukkasillaan	sukkasilla-an 	2
sulattanut	sulatta-nut 	2
suli	sul-i 	2
sunnuntaina	sunnuntai-na 	2
suojattinsa	suojatti-nsa 	2
suomalaisten	suomalais-ten 	2
suomen	suome-n 	2
Suomen	Suome-n 	2
suomessa	suome-ssa 	2
Suomessa	Suome-ssa 	2
Suomesta	Suome-sta 	2
suosiolle	suosio-lle 	2
suosiossa	suosio-ssa 	2
suositaan	suosi-taan 	2
suosituin	suositu-in 	2
suunnan	suunna-n 	2
suuntaan	suuntaa-n 	2
suuntia	suunti-a 	2
suurempi	suure-mpi 	2
suurena	suure-na 	2
suuren	suure-n 	2
suurin	suur-in 	2
suvereeniin	suvereeni-in 	2
syksystä	syksy-stä 	2
syksyyn	syksy-yn 	2
syntyä	synty-ä 	2
syntyi	synty-i 	2
syytökset	syytökse-t 	2
syyttää	syyttä-ä 	2
taakseen	taakse-en 	2
taitoa	taito-a 	2
taivutuksessa	taivutukse-ssa 	2
Taka-alalle	Taka-alalle 	2
takaisesta	takaise-sta 	2
tällaista	tällais-ta 	2
tällä	tä-llä 	2
tälle	tä-lle 	2
tämän	tämä-n 	2
tänä	tä-nä 	2
tapahtunut	tapahtu-nut 	2
tapana	tapa-na 	2
tarinan	tarina-n 	2
tarinat-osiossa	tarinat-osiossa 	2
tarinat	tarina-t 	2
tarjonnut	tarjon-nut 	2
tarkan	tarka-n 	2
tarkastelukulman	tarkastelukulma-n 	2
tarkasteluun	tarkastelu-un 	2
tärkein	tärke-in 	2
tärkeydestä	tärkeyde-stä 	2
tarpeeseen	tarpee-seen 	2
tasolla	taso-lla 	2
tauon	tauo-n 	2
taustalla	tausta-lla 	2
tavalla	tava-lla 	2
tavan	tava-n 	2
tavoitteen	tavoittee-n 	2
täytti	täytt-i 	2
teemana	teema-na 	2
teen	tee-n 	2
tehdään	teh-dään 	2
tehnyt	teh-nyt 	2
tehtävään	tehtävä-än 	2
tehtävän	tehtävä-n 	2
tehtävästä	tehtävä-stä 	2
tehtävät	tehtävä-t 	2
teini-ikäinen	teini-ikäinen 	2
tekemiseksi	tekemise-ksi 	2
tekemisessä	tekemise-ssä 	2
tekevät	tekevä-t 	2
teki	tek-i 	2
tekniikalla	tekniika-lla 	2
teorian	teoria-n 	2
teosten	teos-ten 	2
tiedän	tiedä-n 	2
tiedon	tiedo-n 	2
tiedot	tiedo-t 	2
tiedotti	tiedott-i 	2
tiedotusväline	tiedotus-väline 	2
tiedustelupäällikön	tiedustelupäällikö-n 	2
tietohallintoryhmään	tietohallintoryhmä-än 	2
tietohallintostrategiaa	tietohallintostrategia-a 	2
tietoisuuteen	tietoisuute-en 	2
tietokone	tieto-kone 	2
tietyn	tiety-n 	2
tiiminä	tiimi-nä 	2
Tiktok-sovelluksessa	Tiktok-sovelluksessa 	2
tilannetta	tilannet-ta 	2
tilannut	tilan-nut 	2
tilanteessa	tilantee-ssa 	2
tiuhaan	tiuha-an 	2
tiukkana	tiukka-na 	2
tohtorikoulutusta	tohtorikoulutus-ta 	2
toimesta	toime-sta 	2
toimii	toimi-i 	2
toimimme	toimi-mme 	2
toimintaa	toiminta-a 	2
toiminut	toimi-nut 	2
toimistopöydällä	toimistopöydä-llä 	2
toimitettu	toimitet-tu 	2
toimittajana	toimittaja-na 	2
toimitti	toimitt-i 	2
toimivan	toimiva-n 	2
toimivat	toimiva-t 	2
toiseen	toise-en 	2
toiselle	toise-lle 	2
toisesta	toise-sta 	2
toiveet	toivee-t 	2
tölkin	tölki-n 	2
torjuisi	torju-isi 	2
torstaina	torstai-na 	2
torstain	torstai-n 	2
toteaa	totea-a 	2
toteutettu	toteutet-tu 	2
toteuttaminen	toteutta-minen 	2
toteutti	toteutt-i 	2
tuhanteen	tuhante-en 	2
tukea	tuke-a 	2
tulee	tule-e 	2
tulevaisuuden	tulevaisuude-n 	2
tulevaisuutta	tulevaisuut-ta 	2
tulevaksi	tuleva-ksi 	2
tulevat	tuleva-t 	2
tulisi	tul-isi 	2
tullut	tul-lut 	2
tuloksen	tulokse-n 	2
tunnetaan	tunne-taan 	2
tunnetuksi	tunnetu-ksi 	2
tunnin	tunni-n 	2
tunnistaa	tunnista-a 	2
tunnistaminen	tunnista-minen 	2
tunnustaa	tunnusta-a 	2
tuntumassa	tuntuma-ssa 	2
tuoda	tuod-a 	2
tuomaristoa	tuomaristo-a 	2
tuomiota	tuomio-ta 	2
tuoreeltaan	tuoreelta-an 	2
tuottanut	tuotta-nut 	2
tuotteeksi	tuottee-ksi 	2
tuotteet	tuottee-t 	2
turvallisuuden	turvallisuude-n 	2
tusinalle	tusina-lle 	2
tutkijaksi	tutkija-ksi 	2
tutkijakurssit	tutkijakurssi-t 	2
tutkijana	tutkija-na 	2
tutkimukselle	tutkimukse-lle 	2
tutkimuksen	tutkimukse-n 	2
tutkimuksessa	tutkimukse-ssa 	2
tutkimuksesta	tutkimukse-sta 	2
tutkintapyyntöön	tutkintapyyntö-ön 	2
tuudittauduttu	tuudittaudut-tu 	2
työni	työ-ni 	2
työn	työ-n 	2
työpaikan	työpaika-n 	2
työskennellä	työskennell-ä 	2
työskennellyt	työskennel-lyt 	2
työskenteli	työskentel-i 	2
työstäminen	työstä-minen 	2
työtä	työ-tä 	2
tyyliin	tyyli-in 	2
uhkakuvaretoriikka	uhka-kuvaretoriikka 	2
unionin	unioni-n 	2
uraa	ura-a 	2
usean	usea-n 	2
useat	usea-t 	2
uskotaan	usko-taan 	2
uskottavuutta	uskottavuut-ta 	2
uudella	uude-lla 	2
uuden	uude-n 	2
uudet	uude-t 	2
uusia	uusi-a 	2
uutena	uute-na 	2
uutta	uut-ta 	2
vaalean	vaalea-n 	2
vaalityössä	vaalityö-ssä 	2
vaarassa	vaara-ssa 	2
vaatimukset	vaatimukse-t 	2
väen	väe-n 	2
väheksyntää	väheksyntä-ä 	2
vahvaa	vahva-a 	2
vahvan	vahva-n 	2
vahvasta	vahva-sta 	2
vahvin	vahv-in 	2
vahvuisten	vahvuis-ten 	2
vahvuutena	vahvuute-na 	2
vaiheessa	vaihee-ssa 	2
vaihtaa	vaihta-a 	2
vaihtelua	vaihtelu-a 	2
vaikutusta	vaikutus-ta 	2
väittää	väittä-ä 	2
väittänyt	väittä-nyt 	2
vaivautunut	vaivautu-nut 	2
vakavalla	vakava-lla 	2
vakavana	vakava-na 	2
väliä	väli-ä 	2
valikoimaan	valikoima-an 	2
valikoimassa	valikoima-ssa 	2
valikoimat	valikoima-t 	2
valinnut	valin-nut 	2
valintaa	valinta-a 	2
valitaan	vali-taan 	2
valittiin	valit-tiin 	2
valmiiksi	valmii-ksi 	2
valmiina	valmii-na 	2
valmistui	valmistu-i 	2
valtakunnallinen	valta-kunnallinen 	2
varasijalle	varasija-lle 	2
varmistaa	varmista-a 	2
varmisteleva	varmistele-va 	2
Varsinais-Suomen	Varsinais-Suomen 	2
vasemmistoliitolle	vasemmistoliito-lle 	2
vasemmistoliiton	vasemmistoliito-n 	2
vasemmistoliitossa	vasemmistoliito-ssa 	2
vasemmistoliittoa	vasemmistoliitto-a 	2
vasemmiston	vasemmisto-n 	2
vasemmistopoliitikko	vasemmisto-poliitikko 	2
vastaavana	vastaava-na 	2
vastaavat	vastaava-t 	2
vastavoima	vasta-voima 	2
vastinetta	vastinet-ta 	2
vastustajansa	vastustaja-nsa 	2
vauhtiin	vauhti-in 	2
vei	ve-i 	2
velallisen	velallise-n 	2
velvollisuutensa	velvollisuute-nsa 	2
vertailussa	vertailu-ssa 	2
vieraaksi	vieraa-ksi 	2
vierailuaikaan	vierailuaika-an 	2
viereisestä	viereise-stä 	2
viestii	viesti-i 	2
viestinnän	viestinnä-n 	2
viestintää	viestintä-ä 	2
viestintäkoulutuskohun	viestintäkoulutuskohu-n 	2
viestintänsä	viestintä-nsä 	2
vihreät	vihreä-t 	2
viidellä	viide-llä 	2
viiden	viide-n 	2
viikkoa	viikko-a 	2
viikolla	viiko-lla 	2
viikon	viiko-n 	2
viiniä	viini-ä 	2
viisitoista	viisi-toista 	2
vilkastua	vilkastu-a 	2
virheen	virhee-n 	2
viron	viro-n 	2
voidaan	voi-daan 	2
voimaan	voima-an 	2
voisi	voi-si 	2
voittava	voitta-va 	2
voittoa	voitto-a 	2
vokaalivaihtelua	vokaalivaihtelu-a 	2
vuodelta	vuode-lta 	2
vuoden	vuode-n 	2
vuodessa	vuode-ssa 	2
vuodesta	vuode-sta 	2
vuodet	vuode-t 	2
vuoksi	vuo-ksi 	2
vuotta	vuot-ta 	2
yhden	yhde-n 	2
yhdistää	yhdistä-ä 	2
yhdysvaltalaista	yhdysvaltalais-ta 	2
yhteisen	yhteise-n 	2
yhteydessä	yhteyde-ssä 	2
yhtiöksi	yhtiö-ksi 	2
yhtiössä	yhtiö-ssä 	2
yhtiötä	yhtiö-tä 	2
yksilölliseksi	yksilöllise-ksi 	2
yksinkertaisella	yksinkertaise-lla 	2
yksinkertaiset	yksinkertaise-t 	2
yksinkertaista	yksin-kertaista 	2
yksittäisen	yksittäise-n 	2
yksittäiset	yksittäise-t 	2
yksityishenkilö	yksityis-henkilö 	2
yksityisyyden	yksityisyyde-n 	2
yleisen	yleise-n 	2
yleiset	yleise-t 	2
ylimmän	ylimmä-n 	2
yliopisto	yli-opisto 	2
ylivoimainen	yli-voimainen 	2
yllätti	yllätt-i 	2
yllätyksenä	yllätykse-nä 	2
yltänyt	yltä-nyt 	2
ymmärtänyt	ymmärtä-nyt 	2
ympäristön	ympäristö-n 	2
yöpaikka	yö-paikka 	2
yritän	yritä-n 	2
yrittäjää	yrittäjä-ä 	2
yritti	yritt-i 	2
yritysten	yritys-ten 	2
100-prosenttisesti	100-prosenttise-sti 	3
1980-luvulla	1980-luvu-lla 	3
1980-luvun	1980-luvu-n 	3
1990-luvun	1990-luvu-n 	3
40-vuotiaat	40-vuotiaa-t 	3
7,5-prosenttista	7,5-prosenttis-ta 	3
äänellään	ääne-llä-än 	3
äänelleen	ääne-lle-en 	3
äänestäjille	äänestäj-i-lle 	3
äänestäjistä	äänestäj-i-stä 	3
äänestämään	äänestä-mä-än 	3
äänestettiin	äänestet-ti-in 	3
äänestyskäyttäytymistä	äänestys-käyttäytymis-tä 	3
ääniä	ään-i-ä 	3
äänimäärän	ääni-määrä-n 	3
äänimäärästä	ääni-määrä-stä 	3
äänisaaliita	äänisaali-i-ta 	3
äänisaalistaan	äänisaalis-ta-an 	3
äänteiden	äänte-i-den 	3
absoluuttisia	absoluuttis-i-a 	3
ahdistavaksi	ahdista-va-ksi 	3
aihepiiriin	aihe-piiri-in 	3
aikoina	aiko-i-na 	3
aikojen	aiko-j-en 	3
ajamaan	aja-ma-an 	3
ajankohtaiseksi	ajan-kohtaise-ksi 	3
ajateltua	ajatel-tu-a 	3
ajattelevat	ajattele-va-t 	3
ajatuksia	ajatuks-i-a 	3
ajatustensa	ajatus-te-nsa 	3
aktivoituneet	aktivoitu-nee-t 	3
alapuolelle	ala-puole-lle 	3
alkanutta	alka-nut-ta 	3
alkoholituotteiden	alkoholituotte-i-den 	3
alkupuolella	alku-puole-lla 	3
aloilla	alo-i-lla 	3
aluevaaleissa	aluevaale-i-ssa 	3
alustoilla	alusto-i-lla 	3
ampumistapaus	ampu-mi-stapaus 	3
analysoimassa	analysoi-ma-ssa 	3
analysoituna	analysoi-tu-na 	3
antavaa	anta-va-a 	3
antavat	anta-va-t 	3
artikkelissaan	artikkeli-ssa-an 	3
arvoja	arvo-j-a 	3
arvokkaimmaksi	arvokka-imma-ksi 	3
asiakkaita	asiakka-i-ta 	3
asioiden	asioid-e-n 	3
asioista	asio-i-sta 	3
asioita	asio-i-ta 	3
astevaihtelua	aste-vaihtelu-a 	3
asuntolainaa	asunto-laina-a 	3
automaattien	automaatt-i-en 	3
avauduttua	avaudut-tu-a 	3
äyräiden	äyrä-i-den 	3
budjettivaliokunnassa	budjettivalio-kunna-ssa 	3
dollareihin	dollare-i-hin 	3
edellisistä	edellis-i-stä 	3
eduskunnan	edus-kunna-n 	3
eduskunnassa	edus-kunna-ssa 	3
eduskuntaan	edus-kunta-an 	3
eduskuntavaalimenestyksensä	edus-kuntavaalimenestykse-nsä 	3
ehdoille	ehdo-i-lle 	3
ehdottomista	ehdottom-i-sta 	3
elettiin	elet-ti-in 	3
elinkeinoministerinä	elin-keinoministeri-nä 	3
elokuussa	elo-kuu-ssa 	3
energiavaliokunnassa	energiavalio-kunna-ssa 	3
ennakkoäänten	ennakko-ään-ten 	3
ensin	ens-i-n 	3
epäillystä	epäil-ly-stä 	3
epälukuisessa	epä-lukuise-ssa 	3
epämuodollista	epä-muodollis-ta 	3
epäuskoisena	epä-uskoise-na 	3
erämaasta	erä-maa-sta 	3
erilaisia	erilais-i-a 	3
erinomaisen	erin-omaise-n 	3
eroavat	eroa-va-t 	3
esimerkiksi	esi-merki-ksi 	3
esimerkkiaineiston	esi-merkkiaineisto-n 	3
esittivät	esitt-i-vät 	3
estämään	estä-mä-än 	3
etenin	eten-i-n 	3
EU-eron	EU-ero-n 	3
euroihin	euro-i-hin 	3
europarlamentaarikkoa	euro-parlamentaarikko-a 	3
europarlamentaarikoksi	euro-parlamentaariko-ksi 	3
europarlamentin	euro-parlamenti-n 	3
europarlamentissa	euro-parlamenti-ssa 	3
europarlamentista	euro-parlamenti-sta 	3
europarlamenttiin	euro-parlamentti-in 	3
europarlamenttipaikkaa	euro-parlamenttipaikka-a 	3
eurovaaleissa	eurovaale-i-ssa 	3
eurovaaleja	eurovaale-j-a 	3
FIN-CLARIN-hankkeessa	FIN-CLARIN-hankkeessa 	3
frekvenssejä	frekvensse-j-ä 	3
gallupeihin	gallupe-i-hin 	3
gallupeissa	gallupe-i-ssa 	3
haastatteluiden	haastattelu-i-den 	3
hahmoihin	hahmo-i-hin 	3
hahmotettavalla	hahmotet-tava-lla 	3
hallinneet	hallin-nee-t 	3
hallituksissa	hallituks-i-ssa 	3
hallituskaudella	hallitus-kaude-lla 	3
haluavat	halua-va-t 	3
heinäkuun	heinä-kuu-n 	3
heistä	he-i-stä 	3
helpomman	helpo-mma-n 	3
heräämisensä	herää-mise-nsä 	3
herättäneet	herättä-nee-t 	3
hinnoiteltuna	hinnoitel-tu-na 	3
humanistien	humanist-i-en 	3
humanistisiin	humanistis-i-in 	3
hyllyiltä	hylly-i-ltä 	3
hyllyistä	hylly-i-stä 	3
hyllytettiin	hyllytet-ti-in 	3
hyllyttämään	hyllyttä-mä-än 	3
hyödyllisiä	hyödyllis-i-ä 	3
hyödyntämiseksi	hyödyntä-mise-ksi 	3
hyökättyä	hyökät-ty-ä 	3
hyppyään	hyppy-ä-än 	3
hyvillä	hyv-i-llä 	3
illanvietot	illan-vieto-t 	3
ilmastotavoitteille	ilmastotavoitte-i-lle 	3
iloisia	ilois-i-a 	3
ilosta	ilo-s-ta 	3
iltapäivällä	ilta-päivä-llä 	3
insinöörien	insinöör-i-en 	3
italialaisia	italialais-i-a 	3
IT-huuman	IT-huuma-n 	3
itkettiin	itket-ti-in 	3
itselleen	itse-lle-en 	3
jääneet	jää-nee-t 	3
jalkojen	jalko-j-en 	3
jaostopäälliköksi	jaosto-päällikö-ksi 	3
järjestäjien	järjestäj-i-en 	3
järjestämisestä	järjestä-mise-stä 	3
järjestettiin	järjestet-ti-in 	3
jäseninä	jäsen-i-nä 	3
jäsenistä	jäsen-i-stä 	3
jatkossa	jatko-s-sa 	3
jatkuivat	jatku-i-vat 	3
jättämän	jättä-mä-n 	3
jättämässä	jättä-mä-ssä 	3
jättävänsä	jättä-vä-nsä 	3
johtokunnan	johto-kunna-n 	3
johtokuntaan	johto-kunta-an 	3
joiden	jo-i-den 	3
joilla	jo-i-lla 	3
joissa	jo-i-ssa 	3
joista	jo-i-sta 	3
joita	jo-i-ta 	3
jonkinlaista	jonkin-lais-ta 	3
joukkueenjohtajat	joukkuee-njohtaja-t 	3
joulukuuhun	joulu-kuu-hun 	3
julkaistua	julkais-tu-a 	3
julkaisuja	julkaisu-j-a 	3
kaikkien	kaikk-i-en 	3
kaikkiin	kaikk-i-in 	3
kannatushuipussaan	kannatushuipu-ssa-an 	3
kannatusmittauksissa	kannatusmittauks-i-ssa 	3
kansainväliset	kansain-välise-t 	3
kansanedustajana	kansan-edustaja-na 	3
kansanedustajan	kansan-edustaja-n 	3
kansanliikkeen	kansan-liikkee-n 	3
kansanryhmää	kansa-nryhmä-ä 	3
kansanterveyden	kansan-terveyde-n 	3
käsiteltiin	käsitel-ti-in 	3
käsittelevän	käsittele-vä-n 	3
kaudellaan	kaude-lla-an 	3
kaudelleen	kaude-lle-en 	3
kaupoissa	kaupo-i-ssa 	3
kaupparyhmissä	kaupparyhm-i-ssä 	3
kauppoihin	kauppo-i-hin 	3
kaupunginvaltuuston	kaupungin-valtuusto-n 	3
kaupunginvaltuustossa	kaupungin-valtuusto-ssa 	3
kävivät	käv-i-vät 	3
käynnistyttyä	käynnistyt-ty-ä 	3
käynnistyvät	käynnisty-vä-t 	3
käytiin	käy-ti-in 	3
kehitettävissä	kehitettäv-i-ssä 	3
kehittämään	kehittä-mä-än 	3
kehittämiseen	kehittä-mise-en 	3
kehittämisen	kehittä-mise-n 	3
kehittämisestä	kehittä-mise-stä 	3
keksivät	keksi-vä-t 	3
keräämää	kerää-mä-ä 	3
keräsivät	keräs-i-vät 	3
kertoivat	kerto-i-vat 	3
kertovat	kerto-va-t 	3
kesäkuun	kesä-kuu-n 	3
kesäpaikan	kesä-paika-n 	3
keskiviikkona	keski-viikko-na 	3
keskuspankin	keskus-panki-n 	3
keskustelleet	keskustel-lee-t 	3
keskusteluja	keskustelu-j-a 	3
ketjuihin	ketju-i-hin 	3
kieliaineistoja	kieliaineisto-j-a 	3
kielille	kiel-i-lle 	3
kielissä	kiel-i-ssä 	3
kieliteknologeille	kieliteknologe-i-lle 	3
kieliteknologiapäivien	kieliteknologiapäiv-i-en 	3
kielitiedettä	kieli-tiedet-tä 	3
kielitieteen	kieli-tietee-n 	3
kielitieteeseen	kieli-tietee-seen 	3
kielitieteilijän	kieli-tieteilijä-n 	3
kiihottamisesta	kiihotta-mise-sta 	3
kiinnostavimmat	kiinnostav-imma-t 	3
kiinnostuvan	kiinnostu-va-n 	3
kiireisistä	kiireis-i-stä 	3
kilpailukyvystä	kilpailu-kyvy-stä 	3
kirjojen	kirjo-j-en 	3
kisojen	kiso-j-en 	3
kiusallisia	kiusallis-i-a 	3
kohdistuvaa	kohdistu-va-a 	3
kokemuksia	kokemuks-i-a 	3
kokonaisuuksien	kokonaisuuks-i-en 	3
kokopitkän	koko-pitkä-n 	3
kollegoja	kollego-j-a 	3
kolmiloikan	kolmi-loika-n 	3
konferenssien	konferenss-i-en 	3
korkeammalla	korkea-mma-lla 	3
korkojen	korko-j-en 	3
korkoliikkeillä	korkoliikke-i-llä 	3
koronlaskuodotukset	koro-nlaskuodotukse-t 	3
korostuivat	korostu-i-vat 	3
korruptoituneeksi	korruptoitu-nee-ksi 	3
kortein	korte-i-n 	3
kovemmat	kove-mma-t 	3
kovia	kov-i-a 	3
koviksi	kov-i-ksi 	3
kuluivat	kulu-i-vat 	3
kuluttajien	kuluttaj-i-en 	3
kutsuin	kutsu-i-n 	3
kuukauden	kuu-kaude-n 	3
kuvaelmia	kuvaelm-i-a 	3
kuvailevat	kuvaile-va-t 	3
kymmenesosalla	kymmenes-osa-lla 	3
kymmenkertaisena	kymmen-kertaise-na 	3
kysymyksiä	kysymyks-i-ä 	3
kysymyksissä	kysymyks-i-ssä 	3
kysyviä	kysyv-i-ä 	3
laajenivat	laajen-i-vat 	3
laajojen	laajo-j-en 	3
lähdin	lähd-i-n 	3
läheisiksi	läheis-i-ksi 	3
lähettämään	lähettä-mä-än 	3
lähtevät	lähte-vä-t 	3
lähtökohdan	lähtö-kohda-n 	3
lainsäädäntötyötä	lain-säädäntötyö-tä 	3
lappuja	lappu-j-a 	3
laskeneet	laske-nee-t 	3
laskevan	laske-va-n 	3
laskevansa	laske-va-nsa 	3
leikkaamiselle	leikkaa-mise-lle 	3
leikkauksista	leikkauks-i-sta 	3
levisivät	levis-i-vät 	3
liikenneministerinä	liikenne-ministeri-nä 	3
liiketoimintaan	liike-toiminta-an 	3
liittymisestä	liitty-mise-stä 	3
liittyvää	liitty-vä-ä 	3
liittyvästä	liitty-vä-stä 	3
liittyvät	liitty-vä-t 	3
linjaeroja	linjaero-j-a 	3
lisäpöytäkirjassa	lisäpöytä-kirja-ssa 	3
loistivat	loist-i-vat 	3
lomia	lom-i-a 	3
loppuviikosta	loppu-viiko-sta 	3
loppuvuodesta	loppu-vuode-sta 	3
loukkaamisesta	loukkaa-mise-sta 	3
löydettävissä	löydettäv-i-ssä 	3
löytämään	löytä-mä-än 	3
luottivat	luott-i-vat 	3
lyhyiden	lyhy-i-den 	3
maahanmuutosta	maahan-muuto-sta 	3
maajoukkueen	maa-joukkuee-n 	3
maaliskuun	maalis-kuu-n 	3
maanmiehensä	maan-miehe-nsä 	3
maaseudun	maa-seudu-n 	3
maatalouden	maa-taloude-n 	3
mahdollisimman	mahdollis-imma-n 	3
markkinoiden	markkinoid-e-n 	3
markkinoilla	markkino-i-lla 	3
marraskuun	marras-kuu-n 	3
matemaattisista	matemaattis-i-sta 	3
matkailuvaliokunnassa	matkailuvalio-kunna-ssa 	3
menetelmien	menetelm-i-en 	3
menettämänsä	menettä-mä-nsä 	3
menettivät	menett-i-vät 	3
menikö	men-i-kö 	3
menimme	men-i-mme 	3
menin	men-i-n 	3
menossa	meno-s-sa 	3
merkkejä	merkke-j-ä 	3
miehiä	mieh-i-ä 	3
mielenkiintoisia	mielenkiintois-i-a 	3
mielessään	miele-ssä-än 	3
mielikuvan	mieli-kuva-n 	3
mietoja	mieto-j-a 	3
mietojen	mieto-j-en 	3
ministeripäiviä	ministeripäiv-i-ä 	3
mittalaiteongelmien	mittalaiteongelm-i-en 	3
molemmille	molemm-i-lle 	3
molemmista	molemm-i-sta 	3
monille	mon-i-lle 	3
monissa	mon-i-ssa 	3
muiden	mu-i-den 	3
muilla	mu-i-lla 	3
mukaisia	mukais-i-a 	3
mukavampaa	mukava-mpa-a 	3
murteellisiin	murteellis-i-in 	3
muutkin	muu-t-kin 	3
myönnetyn	myönnet-y-n 	3
myyntitilastoja	myyntitilasto-j-a 	3
naapureina	naapure-i-na 	3
nähtiin	näh-ti-in 	3
näiden	nä-i-den 	3
näillä	nä-i-llä 	3
naisia	nais-i-a 	3
näitä	nä-i-tä 	3
neuvotteluissa	neuvottelu-i-ssa 	3
niillä	ni-i-llä 	3
niille	ni-i-lle 	3
noista	no-i-sta 	3
nousseen	nous-see-n 	3
nousseet	nous-see-t 	3
objektiivisemman	objektiivise-mma-n 	3
odottamaan	odotta-ma-an 	3
ohjauskorkoa	ohjaus-korko-a 	3
oikeinkirjoituksen	oikein-kirjoitukse-n 	3
oikeistohallituksen	oikeisto-hallitukse-n 	3
oikeistolaisemmaksi	oikeistolaise-mma-ksi 	3
oikeuksien	oikeuks-i-en 	3
oikeusministerinä	oikeus-ministeri-nä 	3
olankohautuksella	olan-kohautukse-lla 	3
olettamuksia	olettamuks-i-a 	3
olevia	olev-i-a 	3
oliko	ol-i-ko 	3
olimme	ol-i-mme 	3
olin	ol-i-n 	3
olisin	ol-isi-n 	3
olisivat	ol-isi-vat 	3
olivat	ol-i-vat 	3
ollessa	oll-e-ssa 	3
oluista	olu-i-sta 	3
oluita	olu-i-ta 	3
omistajia	omistaj-i-a 	3
omistamaan	omista-ma-an 	3
omistavan	omista-va-n 	3
ongelmia	ongelm-i-a 	3
ongelmiin	ongelm-i-in 	3
onnellisia	onnellis-i-a 	3
opettajatkin	opettaja-t-kin 	3
opettajille	opettaj-i-lle 	3
opetusministerinä	opetus-ministeri-nä 	3
opetusministerin	opetus-ministeri-n 	3
opetusministeriön	opetus-ministeriö-n 	3
opetusministeriöön	opetus-ministeriö-ön 	3
opiskelemaan	opiskele-ma-an 	3
opiskelijoille	opiskelijo-i-lle 	3
opiskelijoita	opiskelijo-i-ta 	3
oppiaineena	oppi-ainee-na 	3
oppiaineen	oppi-ainee-n 	3
oppituolin	oppi-tuoli-n 	3
oppivat	oppi-va-t 	3
osakekursseilla	osakekursse-i-lla 	3
osakkeiden	osakke-i-den 	3
osakkeissa	osakke-i-ssa 	3
osakkeita	osakke-i-ta 	3
osallistumista	osallistu-mis-ta 	3
osaltani	osa-lta-ni 	3
osia	os-i-a 	3
osiin	os-i-in 	3
osoittavat	osoitta-va-t 	3
ottikin	ott-i-kin 	3
pääesikunnan	pää-esikunna-n 	3
päämajan	pää-maja-n 	3
päänvaivaa	pään-vaiva-a 	3
pääsemässä	pääse-mä-ssä 	3
pääsevät	pääse-vä-t 	3
pääsin	pääs-i-n 	3
pääsisin	pääs-isi-n 	3
päästöjen	päästö-j-en 	3
päätimme	päät-i-mme 	3
päättelivät	päättel-i-vät 	3
päättivät	päätt-i-vät 	3
päätyivät	pääty-i-vät 	3
paikkamääräänsä	paikkamäärä-ä-nsä 	3
päiviä	päiv-i-ä 	3
palveluiden	palvelu-i-den 	3
paradokseja	paradokse-j-a 	3
pärjäävät	pärjää-vä-t 	3
perinteistenkin	perinteis-ten-kin 	3
perjantaikahveista	perjantaikahve-i-sta 	3
perusopetuksen	perus-opetukse-n 	3
perussuomalaisille	perussuomalais-i-lle 	3
perustajajäsenet	perustaja-jäsene-t 	3
perustelin	perustel-i-n 	3
perustikin	perust-i-kin 	3
perustimme	perust-i-mme 	3
perustutkinnon	perus-tutkinno-n 	3
pidemmälle	pide-mmä-lle 	3
pidettiin	pidet-ti-in 	3
pienempiin	piene-mpi-in 	3
piirilevyjä	piirilevy-j-ä 	3
pikavoitosta	pika-voito-sta 	3
pitäisikö	pitä-isi-kö 	3
pitkiä	pitk-i-ä 	3
pohjoismaisten	pohjois-mais-ten 	3
pohtimaan	pohti-ma-an 	3
poistettua	poistet-tu-a 	3
pörssilistan	pörssi-lista-n 	3
pöytäkirjasta	pöytä-kirja-sta 	3
presidentinvaalit	presidentin-vaali-t 	3
presidenttiehdokkaan	presidentti-ehdokkaa-n 	3
prosenttiyksikköä	prosentti-yksikkö-ä 	3
pudottauduin	pudottaudu-i-n 	3
puheenjohtajaksi	puheen-johtaja-ksi 	3
puheenjohtajana	puheen-johtaja-na 	3
puheenjohtajan	puheen-johtaja-n 	3
puheenjohtajuudelle	puheen-johtajuude-lle 	3
puheenjohtajuudesta	puheen-johtajuude-sta 	3
puitteissa	puitte-i-ssa 	3
punavihreään	puna-vihreä-än 	3
punavihreän	puna-vihreä-n 	3
puolueellisuusspekulaatioita	puolueellisuusspekulaatio-i-ta 	3
puolueiden	puolue-i-den 	3
puolueille	puolue-i-lle 	3
puolueissa	puolue-i-ssa 	3
puoluekannalla	puolue-kanna-lla 	3
puoluekokouksessa	puolue-kokoukse-ssa 	3
puolueuskollisuutta	puolue-uskollisuut-ta 	3
puolustusvaliokunnan	puolustusvalio-kunna-n 	3
putosivat	putos-i-vat 	3
radoilla	rado-i-lla 	3
rahapolitiikkaan	raha-politiikka-an 	3
rakensivat	rakens-i-vat 	3
ratkaisuja	ratkaisu-j-a 	3
riehakkaiksi	riehakka-i-ksi 	3
riippumattomia	riippumattom-i-a 	3
rikastuneensa	rikastu-nee-nsa 	3
rinnakkaisilla	rinnakkais-i-lla 	3
ristiriidasta	risti-riida-sta 	3
rivien	riv-i-en 	3
runoharrastuksestaan	runoharrastukse-sta-an 	3
ruotsalaismedian	ruotsalai-smedia-n 	3
ryhdyimme	ryhdy-i-mme 	3
saadun	saa-du-n 	3
saaneeseen	saa-nee-seen 	3
säännöillä	säännö-i-llä 	3
säännöstöihin	säännöstö-i-hin 	3
säännöstöjä	säännöstö-j-ä 	3
sääntöjä	sääntö-j-ä 	3
sääntöjen	sääntö-j-en 	3
saapuivat	saapu-i-vat 	3
saatoimme	saato-i-mme 	3
saatoin	saato-i-n 	3
saikin	sa-i-kin 	3
säilyttivät	säilytt-i-vät 	3
sain	sa-i-n 	3
samantapaisia	samantapais-i-a 	3
sananmuotojen	sananmuoto-j-en 	3
sanojen	sano-j-en 	3
satapäiselle	sata-päise-lle 	3
satoihin	sato-i-hin 	3
selittävätkin	selittävä-t-kin 	3
selviteltiin	selvitel-ti-in 	3
siirtyneen	siirty-nee-n 	3
sijaitsevan	sijaitse-va-n 	3
sijoittajista	sijoittaj-i-sta 	3
silloin	sillo-i-n 	3
silmäpusseista	silmäpusse-i-sta 	3
silmissä	silm-i-ssä 	3
sisäministerinä	sisä-ministeri-nä 	3
sketsejä	sketse-j-ä 	3
sokeita	soke-i-ta 	3
sosiaalipolitiikan	sosiaali-politiika-n 	3
splittauksia	splittauks-i-a 	3
suhteutettuna	suhteutet-tu-na 	3
sukupuolten	suku-puol-ten 	3
sulaneet	sula-nee-t 	3
suoritetuksi	suoritet-u-ksi 	3
suosittujen	suosittu-j-en 	3
suupielet	suu-piele-t 	3
suurimman	suur-imma-n 	3
syitä	sy-i-tä 	3
syntyikin	synty-i-kin 	3
syytöksiksi	syytöks-i-ksi 	3
syytteitä	syytte-i-tä 	3
tahtovat	tahto-va-t 	3
taipumisesta	taipu-mise-sta 	3
talletuskorkoa	talletus-korko-a 	3
taloudenhoitajana	talouden-hoitaja-na 	3
talouspolitiikassa	talous-politiika-ssa 	3
talouspolitiikkaan	talous-politiikka-an 	3
tämänkertaiset	tämän-kertaise-t 	3
tarjoavan	tarjoa-va-n 	3
tarjosivat	tarjos-i-vat 	3
tärkeiksi	tärke-i-ksi 	3
tärkeintä	tärke-in-tä 	3
tarkoitetulla	tarkoitet-u-lla 	3
tarkoitetut	tarkoitet-u-t 	3
tasa-arvon	tasa-arvo-n 	3
tavoitteenani	tavoittee-na-ni 	3
tavutusalgoritmeja	tavutusalgoritme-j-a 	3
tehtäväkseen	tehtävä-kse-en 	3
tehtävälappuja	tehtävälappu-j-a 	3
tehtävätkin	tehtävä-t-kin 	3
tehtäviä	tehtäv-i-ä 	3
tehtäville	tehtäv-i-lle 	3
tehtävistä	tehtäv-i-stä 	3
tein	te-i-n 	3
tekemään	teke-mä-än 	3
tekivät	tek-i-vät 	3
tekoälybuumia	teko-älybuumi-a 	3
tekoälyn	teko-äly-n 	3
tekoälyyn	teko-äly-yn 	3
teollisuuspolitiikkaan	teollisuus-politiikka-an 	3
terveysvaliokunnan	terveysvalio-kunna-n 	3
tiesin	ties-i-n 	3
tietämättä	tietä-mä-ttä 	3
tieteiden	tiete-i-den 	3
tietoja	tieto-j-a 	3
tietojenkäsittelijä	tieto-j-enkäsittelijä 	3
tietojenkäsittelyoppi	tietojen-käsittely-oppi 	3
tietojenkäsittelytaustani	tietojen-käsittelytausta-ni 	3
tietokoneella	tieto-konee-lla 	3
tietokoneen	tieto-konee-n 	3
tietokoneohjelma	tieto-kone-ohjelma 	3
tietotekniikan	tieto-tekniika-n 	3
tietynlaista	tietyn-lais-ta 	3
tilanneet	tilan-nee-t 	3
tilastollisia	tilastollis-i-a 	3
tiukempaa	tiuke-mpa-a 	3
todellisiksi	todellis-i-ksi 	3
todennäköisenä	toden-näköise-nä 	3
todistavansa	todista-va-nsa 	3
töihin	tö-i-hin 	3
toimiiko	toimi-i-ko 	3
toimimaan	toimi-ma-an 	3
toiminnanjohtajana	toiminnan-johtaja-na 	3
toimittajia	toimittaj-i-a 	3
toisiin	tois-i-in 	3
toisilla	tois-i-lla 	3
totesivat	totes-i-vat 	3
toteuttamaan	toteutta-ma-an 	3
toteutumista	toteutum-i-sta 	3
totuuksista	totuuks-i-sta 	3
toukokuun	touko-kuu-n 	3
tuhansiin	tuhans-i-in 	3
tuleekin	tule-e-kin 	3
tulevaisuusvaliokunnan	tulevaisuusvalio-kunna-n 	3
tulevissa	tulev-i-ssa 	3
tulleet	tul-lee-t 	3
tunnettujen	tunnettu-j-en 	3
tunnistamisen	tunnista-mise-n 	3
tunnistamista	tunnista-mis-ta 	3
tunteja	tunte-j-a 	3
tuntemaan	tunte-ma-an 	3
tuotemerkin	tuote-merki-n 	3
tuotevalikoiman	tuote-valikoima-n 	3
tuotteita	tuotte-i-ta 	3
turvallisuuspoliittista	turvallisuus-poliittis-ta 	3
turvallisuusteemoilla	turvallisuusteemo-i-lla 	3
tutkijallekin	tutkija-lle-kin 	3
tutkijanuraa	tutkijan-ura-a 	3
tutkijoilla	tutkijo-i-lla 	3
tutkijoita	tutkijo-i-ta 	3
tutkimushankkeiden	tutkimushankke-i-den 	3
työryhmän	työ-ryhmä-n 	3
työstään	työ-stä-än 	3
työstäneet	työstä-nee-t 	3
ulkoministeriksi	ulko-ministeri-ksi 	3
useiden	use-i-den 	3
useita	use-i-ta 	3
uskalletaanko	uskalle-taan-ko 	3
uudistamiselle	uudista-mise-lle 	3
uurnille	uurn-i-lle 	3
vaaleissa	vaale-i-ssa 	3
vaaleista	vaale-i-sta 	3
vaalien	vaali-e-n 	3
vaaligallupien	vaaligallup-i-en 	3
vaalikaudella	vaali-kaude-lla 	3
vaalipiirin	vaali-piiri-n 	3
vaalipiiristä	vaali-piiri-stä 	3
vaalitulosten	vaali-tulos-ten 	3
vaalivalvojaisissa	vaalivalvojais-i-ssa 	3
vaativissa	vaativ-i-ssa 	3
vähäisiä	vähäis-i-ä 	3
vähemmistöosakkaina	vähemmistöosakka-i-na 	3
vahvoista	vahvo-i-sta 	3
vahvoja	vahvo-j-a 	3
vahvuuksia	vahvuuks-i-a 	3
vaihtoehtona	vaihto-ehto-na 	3
vaikeuksia	vaikeuks-i-a 	3
vaikutusvaltaisin	vaikutus-valtais-in 	3
väitöskirjaksi	väitös-kirja-ksi 	3
väittänytkään	väittä-nyt-kään 	3
väitteitä	väitte-i-tä 	3
vakavailmeistä	vakava-ilmeis-tä 	3
vakuuttuneeksi	vakuuttu-nee-ksi 	3
valikoimiin	valikoim-i-in 	3
valiokunnan	valio-kunna-n 	3
valiokunnassa	valio-kunna-ssa 	3
valitseman	valitse-ma-n 	3
vallankumousta	vallan-kumous-ta 	3
valmistavia	valmistav-i-a 	3
valtakunnallisen	valta-kunnallise-n 	3
valtiovarainministeri	valtio-varain-ministeri 	3
vanhoihin	vanho-i-hin 	3
varapuheenjohtaja	vara-puheen-johtaja 	3
varaslähdön	varas-lähdö-n 	3
vastaavuuksien	vastaavuuks-i-en 	3
vastauksissa	vastauks-i-ssa 	3
vauhdittamana	vauhditta-ma-na 	3
veljeksiä	veljeks-i-ä 	3
verkostoitumista	verkostoitu-mis-ta 	3
versioita	versio-i-ta 	3
vetämään	vetä-mä-än 	3
vierastivat	vierast-i-vat 	3
viestejä	vieste-j-ä 	3
viestinnästään	viestinnä-stä-än 	3
viestivät	viesti-vä-t 	3
vihreiden	vihre-i-den 	3
vihreissä	vihre-i-ssä 	3
viikonloppua	viikon-loppu-a 	3
viikonlopulle	viikon-lopu-lle 	3
viikonlopun	viikon-lopu-n 	3
viineistä	viine-i-stä 	3
viinejä	viine-j-ä 	3
viinien	viin-i-en 	3
viitekorkona	viite-korko-na 	3
voisivat	voi-siva-t 	3
vuosina	vuos-i-na 	3
vuosista	vuos-i-sta 	3
vyöryivät	vyöry-i-vät 	3
ydinvoimaluvan	ydin-voimaluva-n 	3
yhdistämällä	yhdistä-mä-llä 	3
yhteisiä	yhteis-i-ä 	3
yhteistyön	yhteis-työ-n 	3
yhteistyötä	yhteis-työ-tä 	3
yhteisymmärrykseen	yhteis-ymmärrykse-en 	3
yksikköhinnan	yksikkö-hinna-n 	3
yksilöitä	yksilö-i-tä 	3
yksittäisiä	yksittäis-i-ä 	3
yksityiselämästä	yksityis-elämä-stä 	3
yläpuolelle	ylä-puole-lle 	3
yleiskielen	yleis-kiele-n 	3
yleispätevällä	yleis-pätevä-llä 	3
ylilyönnin	yli-lyönni-n 	3
yliopistolle	yli-opisto-lle 	3
yliopiston	yli-opisto-n 	3
yliopistossa	yli-opisto-ssa 	3
yliopistot	yli-opisto-t 	3
yllätystulokselle	yllätys-tulokse-lle 	3
ympäristöministerinä	ympäristö-ministeri-nä 	3
ympäristöpolitiikkaa	ympäristö-politiikka-a 	3
40-vuotiaiden	40-vuotia-i-den 	4
äänestäessään	äänestä-e-ssä-än 	4
äänestettäessä	äänestet-tä-e-ssä 	4
äännevaihteluiden	äänne-vaihtelu-i-den 	4
äännevaihteluita	äänne-vaihtelu-i-ta 	4
ajankohtaisia	ajan-kohtais-i-a 	4
ajattelevia	ajattele-v-i-a 	4
alkoholijuomien	alkoholi-juom-i-en 	4
alkuvaiheista	alku-vaihe-i-sta 	4
arkaluonteisia	arka-luonteis-i-a 	4
asuntokunnista	asunto-kunn-i-sta 	4
eduskuntaryhmän	edus-kunta-ryhmä-n 	4
eduskuntaryhmänsä	edus-kunta-ryhmä-nsä 	4
eduskuntatyön	edus-kunta-työ-n 	4
eduskuntatyöstä	edus-kunta-työ-stä 	4
eduskuntavaaleissa	edus-kuntavaale-i-ssa 	4
elintarvikkeiden	elin-tarvikke-i-den 	4
ennallistamissääntelylle	ennallista-mi-ssääntely-lle 	4
esitutkintapöytäkirjat	esi-tutkintapöytä-kirja-t 	4
EU-asioista	EU-asio-i-sta 	4
EU-asioita	EU-asio-i-ta 	4
EU-hankkeiden	EU-hankke-i-den 	4
europarlamenttiuraansa	euro-parlamenttiura-a-nsa 	4
europarlamenttivaaleissa	euro-parlamenttivaale-i-ssa 	4
EU-vaaleissa	EU-vaale-i-ssa 	4
EU-vaalien	EU-vaal-i-en 	4
haikailevia	haikaile-v-i-a 	4
halvempia	halve-mp-i-a 	4
havaittavissa	havait-tav-i-ssa 	4
havaittuja	havait-tu-j-a 	4
henkilötyövuoden	henkilö-työ-vuode-n 	4
illanvietoista	illan-vieto-i-sta 	4
itämurteiden	itä-murte-i-den 	4
jäädäkseen	jääd-ä-kse-en 	4
jääneissä	jää-ne-i-ssä 	4
johdettavissa	johdet-tav-i-ssa 	4
kaikenlaisia	kaiken-lais-i-a 	4
kaksitasosäännöt	kaksi-taso--säännö-t 	4
kansanedustajuuttaan	kansa-nedustajuut-ta-an 	4
kehitettyjen	kehitet-ty-j-en 	4
kehitetyillä	kehitet-y-i-llä 	4
keräämällään	kerää-mä-llä-än 	4
kielimuotoihin	kieli-muoto-i-hin 	4
kielitieteilijöille	kieli-tieteilijö-i-lle 	4
kiinnostuneita	kiinnostu-ne-i-ta 	4
koskevien	koske-v-i-en 	4
kuukausina	kuu-kaus-i-na 	4
laajojakin	laajo-j-a-kin 	4
lakivaliokunnan	laki-valio-kunna-n 	4
lapsuudenystävinä	lapsuuden-ystäv-i-nä 	4
liikepankkien	liike-pankk-i-en 	4
liittyviä	liitty-v-i-ä 	4
liittyvien	liitty-v-i-en 	4
liittyvissä	liitty-v-i-ssä 	4
lisätutkintapöytäkirjasta	lisätutkinta-pöytä-kirja-sta 	4
löytämien	löytä-m-i-en 	4
luonnontieteilijöiden	luonnon-tieteilijö-i-den 	4
määrärahojen	määrä-raho-j-en 	4
maksavia	maksa-v-i-a 	4
muillekin	mu-i-lle-kin 	4
näkyvimpiin	näkyv-imp-i-in 	4
nelivuotiskautta	neli-vuoti-skaut-ta 	4
nuolenpäämerkkien	nuolen-päämerkk-i-en 	4
oivalluksistaan	oivalluks-i-sta-an 	4
omiani	om-i-a-ni 	4
oppiaineista	oppi-aine-i-sta 	4
osoittavinaan	osoitta-v-ina-an 	4
paikkakunnilla	paikka-kunn-i-lla 	4
päivittäistavarakaupan	päivittäis-tavara-kaupa-n 	4
patentoivatkin	patentoi-va-t-kin 	4
perustelevia	perustele-v-i-a 	4
pidettyjen	pidet-ty-j-en 	4
pienpanimoiden	pie-npanimo-i-den 	4
presidentinvaaleissa	presidentin-vaale-i-ssa 	4
punavihreistä	puna-vihre-i-stä 	4
punaviinien	puna-viin-i-en 	4
raha-asioiden	raha-asio-i-den 	4
reilummin	reilu-mm-i-n 	4
ristiriitoja	risti-riito-j-a 	4
rohkeammin	rohkea-mm-i-n 	4
ruokakaupoissa	ruoka-kaupo-i-ssa 	4
ruokaviinejä	ruoka-viine-j-ä 	4
säännönmukaisuuksia	säännön-mukaisuuks-i-a 	4
saatuani	saa-tu-a-ni 	4
saavutettavissa	saavutet-tav-i-ssa 	4
salattaviksi	salat-tav-i-ksi 	4
silmiään	silm-i-ä-än 	4
sisältäviin	sisältä-v-i-in 	4
suomalaisäänestäjistä	suomalai-säänestäj-i-stä 	4
suunnilleen	suunn-i-lle-en 	4
suunnitelmiaan	suunnitelm-i-a-an 	4
suurimpiin	suur-imp-i-in 	4
tarvittaessa	tarvit-ta-e-ssa 	4
täyttäviä	täyttä-v-i-ä 	4
tekoälysiruilla	teko-älysiru-i-lla 	4
tietojenkäsittelyoppia	tietojen-käsittely-oppi-a 	4
tietokoneohjelmani	tieto-kone-ohjelma-ni 	4
tietoverkkojen	tieto-verkko-j-en 	4
tilintarkastustuomioistuimeen	tilin-tarkastustuomio-istuime-en 	4
toisilleen	tois-i-lle-en 	4
toisistaan	tois-i-sta-an 	4
tuettuja	tuet-tu-j-a 	4
tulevaisuudennäkymistä	tulevaisuuden-näkym-i-stä 	4
tuntemille	tunte-m-i-lle 	4
tutkimustuloksia	tutkimus-tuloks-i-a 	4
uhkakuvia	uhka-kuv-i-a 	4
useammilla	usea-mm-i-lla 	4
useammin	usea-mm-i-n 	4
vaalitenteissä	vaali-tente-i-ssä 	4
vaaliuurnilta	vaali-uurn-i-lta 	4
vaikutusvaltaisimmaksi	vaikutus-valtais-imma-ksi 	4
vaikutusvaltaisimman	vaikutus-valtais-imma-n 	4
valiokuntajäsenyyksiä	valio-kuntajäsenyyks-i-ä 	4
valmistuttuani	valmistut-tu-a-ni 	4
vanhempainvapaalle	vanhempa-i-nvapaa-lle 	4
vanhentuneita	vanhentu-ne-i-ta 	4
varapuheenjohtajana	vara-puheen-johtaja-na 	4
vastaääniä	vasta-ään-i-ä 	4
viinipulloja	viini-pullo-j-a 	4
yliopistoista	yli-opisto-i-sta 	4
yliopistojen	yli-opisto-j-en 	4
kaksitasokuvauksiaan	kaksi-tasokuvauks-i-a-an 	5
lähtökohdistaan	lähtö-kohd-i-sta-an 	5
mielipiteitään	mieli-pite-i-tä-än 	5
ohjauskorkojaan	ohjaus-korko-j-a-an 	5
perustuslakivaliokunnan	perustus-laki-valio-kunna-n 	5
tietokoneohjelmien	tieto-kone-ohjelm-i-en 	5
ulkoasiainvaliokunnan	ulko-asiain-valio-kunna-n 	5
väitöskirjantekijöiden	väitös-kirja-ntekijö-i-den 	5
